채널톡 홈페이지에 채용 정보가 업데이트되지 않아서 새로운 채용 정보를 확인하고 싶어요.	['A', 'B', 'E', 'summon']
채널톡 홈페이지에 고객센터 직원 채용 정보가 있는지 확인해 주실 수 있을까요?	['A', 'B', 'error']
채널톡 홈페이지에 채용 정보가 잘 정리되어 있어서 지원서 작성 시간을 단축하고자 합니다. 어떻게 하면 내가 원하는 정보를 더 효율적으로 찾을 수 있을까요?	['A', 'B', 'E', 'summon']
안녕하세요, 채널톡 홈페이지에 있는 개발자 채용 정보가 업데이트 되었나요?	['A', 'B', 'exit']
채널톡 홈페이지에서 구인 공고를 확인하고 싶은데, 맞는 정보를 어떻게 찾을 수 있을까요?	['A', 'B', 'exit']
채널톡 홈페이지에 나와 있는 공고 중에서 IT 개발자 채용에 관한 세부 정보를 알고 싶습니다.	['A', 'B', 'E', 'summon']
채널톡 홈페이지에 구인 정보가 업데이트 되었는지 알고 싶어요.	['A', 'B', 'E', 'summon']
채널톡의 채용 홈페이지에 노출된 직무 소개 페이지를 수정해야 하는데, 그에 대한 안내를 받고 싶어요.	['A', 'B', 'E', 'summon']
채널톡 홈페이지에 취업 공고가 올라오면 알림을 받고 싶어요. 가능한가요?	['A', 'B', 'error']
채널톡 홈페이지에 채용 정보가 업데이트되었는지 확인하고 싶은데, 어디서 확인할 수 있나요?	['A', 'B', 'error']
채널톡 홈페이지에서 채용 정보를 찾다가 어떤 부서에서 일하는 직원들의 인터뷰 영상을 시청하고 싶어요. 가능할까요?	['A', 'C', 'error']
채널톡 홈페이지에 오타가 몇 군데 있어서 수정 요청드립니다.	['A', 'E', 'summon']
채널톡의 홈페이지에서 채용 정보가 업데이트 되기 전에 미리 알고 싶어서 여쭤봅니다.	['A', 'B', 'E', 'exit']
채널톡 홈페이지에 있는 채용 정보에 대해 질문이 있어요. 외국어 능력이 중요한가요?	['A', 'B', 'E', 'summon']
채널톡 홈페이지에 새로운 채용 정보를 업데이트할 때마다 메인페이지 상단에 고정해서 노출시키는 기능을 추가해 주시면 감사하겠습니다.	['A', 'E', 'exit']
채널톡 홈페이지의 구인 정보 중 제목과 내용이 상이한 경우, 수정 요청을 하고 싶습니다.	['A', 'E', 'summon']
채널톡 홈페이지에서 시스템 관리자 채용 정보를 찾고 있습니다. 관련된 자세한 정보를 알려주세요.	['A', 'B', 'error']
채널톡 홈페이지에서 구인 정보를 확인하고 싶은데, 실시간으로 업데이트되는 채용 정보를 알 수 있는 방법이 있을까요?	['A', 'B', 'E', 'summon']
채널톡 홈페이지에 구인관련 새로운 채용 정보가 올라왔을 때, 제 이메일 주소로 알림을 받고 싶습니다. 가능할까요?	['A', 'E', 'summon']
채널톡의 구직 페이지에 신입 사원 채용을 위한 특별한 이벤트가 있나요?	['A', 'B', 'error']
